1111111111111111111111111
1000000000110000000000001
1010000001110000000000001
1011100006000000000000001
1010000001110000000000001
1000000001311111111161111
1111611111333333110000001
1111001111413333320101001
1100000011111121110000001
1000000000000000110000001
1000000000000000110101101
1100000011010101111101111
1111011111110111111101111
1111011111110017100000001
1100000111000000100000001
1000000011000000100000001
1000000011111110101000101
1000000011111111111101111
1100000111000111111101111
1000000010000011010101101
1000000000000000000000001
1000000010000011010101101
1100000111000111111101111
1100000111000111111000111
1111111111111111111111111
