111111111
101100001
101101111
101101111
100000001
111101101
111101101
100001101
111111111
