111111111
100000001
100000111
100000001
111111001
100011001
100011001
100000001
111111111
