1111111111
1000000001
1011111101
1000000001
1111001111
1110000111
1100110011
1001111001
1000000001
1111111111
